World: Java Kara Level 11
X: 9
Y: 9
#########
###### ##
### ## ##
### ## ##
@       #
## ## ###
## ######
## ######
#########
